111111
100001
110001
10N001
100001
111111
