1111111
100N001
1000001
1000001
1000001
1000001
1000001
1000001
1111111
