1111111111111111111111111111111111
1000000000000000000000000000000001
1111110100100000101001000000010101
1010010010101010001001000000010101
1N00000000000000000000000000000001
1111111111111111111111111111111111