
SO ./assets/date.xpm

WE           ./assets/date.xpm
EA ./assets/date.xpm
NO ./assets/date.xpm



        1111111111111111111111111
        1000000000110000000000001
        1011000001110000S00000001
        1111111111111111111111111
F           220,100,0
C 225,30,0