NO ./assets/wall-texture.xpm
SO ./assets/wall-texture.xpm




WE           ./assets/wall-texture.xpm



EA ./assets/wall-texture.xpm
F           220,100,9
C 225,30,0


111111111
100100001
1101N0001
100000001
101000001
100010001
111111111
