NO ./assets/wall-texture.xpm
SO ./assets/wall-texture.xpm




WE           ./assets/wall-texture.xpm



EA ./assets/wall-texture.xpm
F           220,100,9
C 225,30,0



11111
11001
100W1
10011
10001
10001
11111
