NO ./assets/wall-texture.xpm
SO ./assets/wall-texture.xpm




WE           ./assets/wall-texture.xpm



EA ./assets/wall-texture.xpm
F           220,100,9
C 225,30,0


111111111
100101101
110000101
10000W011
101101001
100010001
111111111
