NO ./assets/wall-texture.xpm
SO ./assets/wall-texture.xpm




WE           ./assets/wall-texture.xpm



EA ./assets/wall-texture.xpm
F           220,100,9
C 225,30,0


1111111
1000001
1000001
1000001
1000001
1000001
1000001
10000W1
1111111
